#########.......
#...............
#.......########
#..............#
#......##......#
#......##......#
#.....P........#
###............#
##.............#
#......####..###
#......#.......#
#......#.......#
#..............#
#......#########
#..............#
################